################################################################
................................................................
................................................................
................................................................
................................................................
................................................................
................................................................
................................................................
................................................................
................................................................
................................................................
................................................................
############>...................................................
#############...................................................
................................................................
................................................................
................................................................
................................................................
................................................................
................................................................
................................................................
................................................................
...............<##########>.....................................
...............############.....................................
................................................................
................................................................
................................................................
.............................................<##########>.......
.............................................############.......
.............................................############.......
................................................................
................................................................
................................................................
................................................................
.....<###########>..............................................
.....#############..............................................
................................................................
................................................................
................................................................
................................................................
................................................................
................................................................
....................<###########>...............................
....................#############...............................
....................#############...............................
................................................................
................................................................
................................................................
................................................................
................................................................
................................................................
................................................................
................................................................
................................................................
................................................................
................................................................
................................................................
................................................................
................................................................
................................................................
................................................................
############>...................................................
#############...................................................
................................................................
................................................................
................................................................
................................................................
................................................................
................................................................
................................................................
................................................................
...............<##########>.....................................
...............############.....................................
................................................................
................................................................
................................................................
.............................................<##########>.......
.............................................############.......
.............................................############.......
................................................................
................................................................
................................................................
................................................................
.....<###########>..............................................
.....#############..............................................
................................................................
................................................................
................................................................
................................................................
................................................................
................................................................
....................<###########>...............................
....................#############...............................
....................#############...............................
................................................................
................................................................
................................................................
................................................................
................................................................
................................................................
................................................................
############>...................................................
#############...................................................
................................................................
................................................................
................................................................
................................................................
................................................................
................................................................
................................................................
................................................................
...............<##########>.....................................
...............############.....................................
................................................................
................................................................
................................................................
.............................................<##########>.......
.............................................############.......
.............................................############.......
................................................................
................................................................
................................................................
................................................................
.....<###########>..............................................
.....#############..............................................
................................................................
................................................................
................................................................
................................................................
................................................................
................................................................
....................#??????????#................................
....................????????????................................
....................????????????................................
................................................................
................................................................
................................................................
................................................................
................................................................
................................................................
..............................................##################
###########...................................##################
###########...................................##################
###########...................................##################
###########...................................##################
###########...................................##################
################################################################
################################################################
################################################################
################################################################